NO ./texture/no_texture.xpm
SO ./texture/so_texture.xpm
WE ./texture/we_texture.xpm
EA ./texture/ea_texture.xpm
F 255, 255, 255
C 255,255,255

1111111111111111111111111111111111111111111111
1000000000000000000000000000000000000000000001
1001100000001100000000000000000011000000011001
1001100000001100000000000000000011000000011001
1000000000000000000000000000000000000000000001
1000000000000000000000000000000000000000000001
1000000000000000000000000000000000000000000001
1000000000000000000000000000000000000000000001
1001100000001100000000N00000000011000000011001
1001100000001100000000000000000011000000011001
1000000000000000000000000000000000000000000001
1000000000000000000000000000000000000000000001
1000000000000000000000000000000000000000000001
1000000000000000000000000000000000000000000001
1001100000001100000000000000000011000000011001
1001100000001100000000000000000011000000011001
1000000000000000000000000000000000000000000001
1000000000000000000000000000000000000000000001
1111111111111111111111111111111111111111111111
