NO ./textures/basalt_side.xpm
SO ./textures/basalt_top.xpm
WE ./textures/blackstone.xpm
EA ./textures/blackstone_top.xpm
F 255, 255, 255
C 255,255,255

1111111111111111111
1000010001000100001
1000010000000000001
10000000W0011100001
1000010000000000001
1000000000100010001
1001100000000000001
1001100000000010001
1000000000000000001
1001000000000000001
1000000000000000001
1000000000000000001
1000000000000000001
1111111111111111111
